wiki,slots,comp_mb,ucomp_mb,comp_jobtime,comp_chain1,comp_chain2,comp_datasink,ucomp_jobtime,ucomp_chain1,ucomp_chain2,ucomp_datasink,comp_ratio,diff_jobtime,diff_chain1,diff_chain2,diff_datasink,comp_throughput,ucomp_throughput
aawiki-20160305-pages-meta-history.xml.bz2,100,1,3,6000,5000,2000,28,2000,2000,127,9,3,-4000,-3000,-1873,-19,"0,1666666667","1,5"
aawiki-20160305-pages-meta-history.xml.bz2,200,1,3,3000,3000,232,78,2000,2000,133,9,3,-1000,-1000,-99,-69,"0,3333333333","1,5"
aawiki-20160305-pages-meta-history.xml.bz2,300,1,3,5000,4000,235,84,5000,5000,170,8,3,0,1000,-65,-76,"0,2","0,6"
aawiki-20160305-pages-meta-history.xml.bz2,400,1,3,6000,6000,214,33,6000,6000,1000,17,3,0,0,786,-16,"0,1666666667","0,5"
tenwiki-20160305-pages-meta-history.xml.bz2,100,5,106,1000,1000,285,8,2000,2000,810,16,"21,2",1000,1000,525,8,5,53
tenwiki-20160305-pages-meta-history.xml.bz2,200,5,106,3000,3000,438,6,2000,2000,97,13,"21,2",-1000,-1000,-341,7,"1,6666666667",53
tenwiki-20160305-pages-meta-history.xml.bz2,300,5,106,5000,4000,563,7,4000,4000,116,8,"21,2",-1000,0,-447,1,1,"26,5"
tenwiki-20160305-pages-meta-history.xml.bz2,400,5,106,6000,6000,342,7,5000,5000,134,59,"21,2",-1000,-1000,-208,52,"0,8333333333","21,2"
omwiki-20160305-pages-meta-history.xml.bz2,100,10,149,2000,2000,456,8,2000,2000,848,7,"14,9",0,0,392,-1,5,"74,5"
omwiki-20160305-pages-meta-history.xml.bz2,200,10,149,3000,3000,389,7,3000,3000,92,6,"14,9",0,0,-297,-1,"3,3333333333","49,6666666667"
omwiki-20160305-pages-meta-history.xml.bz2,300,10,149,5000,5000,941,7,4000,4000,127,7,"14,9",-1000,-1000,-814,0,2,"37,25"
omwiki-20160305-pages-meta-history.xml.bz2,400,10,149,7000,7000,851,9,6000,6000,172,6,"14,9",-1000,-1000,-679,-3,"1,4285714286","24,8333333333"
novwiki-20160305-pages-meta-history.xml.bz2,100,15,430,2000,2000,693,7,2000,2000,365,7,"28,6666666667",0,0,-328,0,"7,5",215
novwiki-20160305-pages-meta-history.xml.bz2,200,15,430,3000,3000,559,7,2000,2000,175,8,"28,6666666667",-1000,-1000,-384,1,5,215
novwiki-20160305-pages-meta-history.xml.bz2,300,15,430,4000,4000,479,7,4000,4000,95,12,"28,6666666667",0,0,-384,5,"3,75","107,5"
novwiki-20160305-pages-meta-history.xml.bz2,400,15,430,6000,6000,605,7,5000,5000,164,7,"28,6666666667",-1000,-1000,-441,0,"2,5",86
kwwiki-20160305-pages-meta-history.xml.bz2,100,20,605,3000,3000,1000,7,2000,2000,1000,7,"30,25",-1000,-1000,0,0,"6,6666666667","302,5"
kwwiki-20160305-pages-meta-history.xml.bz2,200,20,605,3000,3000,480,9,3000,3000,228,7,"30,25",0,0,-252,-2,"6,6666666667","201,6666666667"
kwwiki-20160305-pages-meta-history.xml.bz2,300,20,605,5000,5000,1000,7,4000,4000,171,7,"30,25",-1000,-1000,-829,0,4,"151,25"
kwwiki-20160305-pages-meta-history.xml.bz2,400,20,605,6000,6000,217,7,6000,6000,153,7,"30,25",0,0,-64,0,"3,3333333333","100,8333333333"
cowiki-20160305-pages-meta-history.xml.bz2,100,30,707,3000,2000,1000,7,3000,3000,1000,8,"23,5666666667",0,1000,0,1,10,"235,6666666667"
cowiki-20160305-pages-meta-history.xml.bz2,200,30,707,3000,3000,683,8,3000,3000,159,6,"23,5666666667",0,0,-524,-2,10,"235,6666666667"
cowiki-20160305-pages-meta-history.xml.bz2,300,30,707,5000,5000,1000,7,4000,4000,238,7,"23,5666666667",-1000,-1000,-762,0,6,"176,75"
cowiki-20160305-pages-meta-history.xml.bz2,400,30,707,7000,6000,1000,66,6000,6000,723,58,"23,5666666667",-1000,0,-277,-8,"4,2857142857","117,8333333333"
kywiki-20160305-pages-meta-history.xml.bz2,100,60,1148,3000,3000,2000,8,3000,3000,1000,7,"19,1333333333",0,0,-1000,-1,20,"382,6666666667"
kywiki-20160305-pages-meta-history.xml.bz2,200,60,1148,4000,4000,1000,7,4000,4000,1000,10,"19,1333333333",0,0,0,3,15,287
kywiki-20160305-pages-meta-history.xml.bz2,300,60,1148,5000,5000,1000,7,6000,6000,1000,7,"19,1333333333",1000,1000,0,0,12,"191,3333333333"
kywiki-20160305-pages-meta-history.xml.bz2,400,60,1148,7000,7000,1000,11,6000,6000,1000,7,"19,1333333333",-1000,-1000,0,-4,"8,5714285714","191,3333333333"
pswiki-20160305-pages-meta-history.xml.bz2,100,90,1899,5000,4000,3000,9,3000,3000,2000,7,"21,1",-2000,-1000,-1000,-2,18,633
pswiki-20160305-pages-meta-history.xml.bz2,200,90,1899,5000,5000,1000,10,3000,3000,979,8,"21,1",-2000,-2000,-21,-2,18,633
pswiki-20160305-pages-meta-history.xml.bz2,300,90,1899,5000,5000,1000,8,5000,5000,741,7,"21,1",0,0,-259,-1,18,"379,8"
pswiki-20160305-pages-meta-history.xml.bz2,400,90,1899,7000,7000,1000,6,6000,6000,323,7,"21,1",-1000,-1000,-677,1,"12,8571428571","316,5"
guwiki-20160305-pages-meta-history.xml.bz2,100,252,5030,7000,7000,5000,10,5000,5000,4000,12,"19,9603174603",-2000,-2000,-1000,2,36,1006
guwiki-20160305-pages-meta-history.xml.bz2,200,252,5030,8000,8000,5000,10,6000,6000,3000,9,"19,9603174603",-2000,-2000,-2000,-1,"31,5","838,3333333333"
guwiki-20160305-pages-meta-history.xml.bz2,300,252,5030,8000,8000,4000,8,7000,7000,3000,8,"19,9603174603",-1000,-1000,-1000,0,"31,5","718,5714285714"
guwiki-20160305-pages-meta-history.xml.bz2,400,252,5030,8000,8000,2000,7,8000,8000,2000,8,"19,9603174603",0,0,0,1,"31,5","628,75"
kkwiki-20160305-pages-meta-history.xml.bz2,100,526,12619,19000,19000,15000,10,16000,16000,14000,9,"23,9904942966",-3000,-3000,-1000,-1,"27,6842105263","788,6875"
kkwiki-20160305-pages-meta-history.xml.bz2,200,526,12619,16000,16000,13000,9,14000,14000,11000,8,"23,9904942966",-2000,-2000,-2000,-1,"32,875","901,3571428571"
kkwiki-20160305-pages-meta-history.xml.bz2,300,526,12619,14000,14000,10000,9,15000,15000,10000,7,"23,9904942966",1000,1000,0,-2,"37,5714285714","841,2666666667"
kkwiki-20160305-pages-meta-history.xml.bz2,400,526,12619,18000,18000,11000,9,16000,16000,10000,7,"23,9904942966",-2000,-2000,-1000,-2,"29,2222222222","788,6875"
bewiki-20160305-pages-meta-history.xml.bz2,100,1004,19783,27000,27000,21000,9,26000,26000,22000,9,"19,7041832669",-1000,-1000,1000,0,"37,1851851852","760,8846153846"
bewiki-20160305-pages-meta-history.xml.bz2,200,1004,19783,25000,25000,19000,7,26000,26000,23000,8,"19,7041832669",1000,1000,4000,1,"40,16","760,8846153846"
bewiki-20160305-pages-meta-history.xml.bz2,300,1004,19783,23000,23000,19000,8,27000,26000,22000,9,"19,7041832669",4000,3000,3000,1,"43,652173913","732,7037037037"
bewiki-20160305-pages-meta-history.xml.bz2,400,1004,19783,21000,21000,15000,10,27000,27000,21000,9,"19,7041832669",6000,6000,6000,-1,"47,8095238095","732,7037037037"
skwiki-20160305-pages-meta-history.xml.bz2,100,1546,33418,47000,47000,33000,8,41000,41000,32000,9,"21,6157826649",-6000,-6000,-1000,1,"32,8936170213","815,0731707317"
skwiki-20160305-pages-meta-history.xml.bz2,200,1546,33418,41000,41000,27000,9,39000,38000,34000,9,"21,6157826649",-2000,-3000,7000,0,"37,7073170732","856,8717948718"
skwiki-20160305-pages-meta-history.xml.bz2,300,1546,33418,40000,40000,29000,11,38000,38000,34000,9,"21,6157826649",-2000,-2000,5000,-2,"38,65","879,4210526316"
skwiki-20160305-pages-meta-history.xml.bz2,400,1546,33418,33000,33000,26000,9,38000,38000,32000,10,"21,6157826649",5000,5000,6000,1,"46,8484848485","879,4210526316"
trwiki-20160305-pages-meta-history.xml.bz2,100,5769,129885,163000,163000,103000,42,186000,186000,47000,9,"22,514300572",23000,23000,-56000,-33,"35,3926380368","698,3064516129"
trwiki-20160305-pages-meta-history.xml.bz2,200,5769,129885,144000,144000,95000,45,161000,161000,130000,8,"22,514300572",17000,17000,35000,-37,"40,0625","806,7391304348"
trwiki-20160305-pages-meta-history.xml.bz2,300,5769,129885,130000,130000,86000,10,160000,160000,146000,8,"22,514300572",30000,30000,60000,-2,"44,3769230769","811,78125"
trwiki-20160305-pages-meta-history.xml.bz2,400,5769,129885,131000,131000,87000,54,160000,160000,145000,8,"22,514300572",29000,29000,58000,-46,"44,0381679389","811,78125"
huwiki-20160305-pages-meta-history.xml.bz2,100,11187,228813,268000,268000,182000,9,347000,346000,45000,8,"20,4534727809",79000,78000,-137000,-1,"41,7425373134","659,4034582133"
huwiki-20160305-pages-meta-history.xml.bz2,200,11187,228813,261000,261000,191000,10,317000,316000,105000,8,"20,4534727809",56000,55000,-86000,-2,"42,8620689655","721,8075709779"
huwiki-20160305-pages-meta-history.xml.bz2,300,11187,228813,221000,221000,162000,10,348000,348000,272000,8,"20,4534727809",127000,127000,110000,-2,"50,6199095023","657,5086206897"
huwiki-20160305-pages-meta-history.xml.bz2,400,11187,228813,236000,236000,176000,10,342000,342000,288000,8,"20,4534727809",106000,106000,112000,-2,"47,4025423729","669,0438596491"
